#########################
#.....#..#......#####.#.#
#...#...##....###...#.#.#
#...#.#....####.....#.#.#
#.......##......#####.#.#
#...#.##.#....###...#.#.#
#...............#####.#.#
#.....##.#......#####.#.#
#...#.##.#....###...#.#.#
#...#.##.#....###...#.#.#
#...............#####.#.#
#########################
.ee......................