#########################
#..........#..........#.#
#..........#..........#.#
#..######..#..######..#.#
#..#....#.....#....#....#
#..#....#.....#....#....#
#.......#.....#.........#
#.......#.....#.........#
#..######..#..######..#.#
#..........#..........#.#
#..........#..........#.#
#########################